WWWWWWWWWWWWWWW
WW----M-------W
W----WWWWW-E--W
WW--WWWW---WW-W
WW-----WWWWWWWW
WWW--------T-WW
WWWW------WWWWW
WWW----W--N-WWW
WW--WWWWW----WW
WW----WWWWW---W
WWW----------WW
WWWW--WW-W--WWW
WWWWWW----WWWWW
WWWWWWWGWWWWWWW
WWWWWWWWWWWWWWW