WWWWWWWWWWWWWWW
WW----M-------W
W----WWWWW----W
WW--WWWWWWWWW-W
WW-----WWWWWWWW
WWW----------WW
WWWW------WWWWW
WWW----W----WWW
WW--WWWWW----WW
WW----WWWWW---W
WWW----------WW
WWWW--------WWW
WWWWWW----WWWWW
WWWWWWWWWWWWWWW